NA NA NA NA NA NA NA NA NA NA NA NA NA NA NA NA NA NA NA NA NA NA NA NA NA NA NA NA NA NA NA NA NA NA NA NA BG NA NA NA
NA NA NA NA NA NA NA NA NA NA NA NA NA NA NA NA NA NA NA NA NA NA NA NA NA NA NA NA NA NA NA NA NA NA NA NA NA NA NA NA
NA NA NA NA NA NA NA NA NA NA NA NA NA NA NA NA NA NA NA NA NA NA NA NA NA NA NA NA NA NA BG NA NA NA NA NA NA NA NA NA
NA NA NA NA NA NA NA NA NA NA NA NA NA NA NA NA NA NA NA NA NA NA NA NA NA NA NA NA NA NA BG NA NA NA NA NA NA NA NA NA
NA NA NA NA NA NA NA NA NA NA NA NA NA NA NA NA NA BG BG NA NA NA BG BG NA NA NA NA NA NA NA NA NA NA NA NA NA NA NA NA
NA NA NA NA NA NA NA NA NA NA NA NA NA NA NA NA NA BG BG NA NA NA BG BG NA NA NA NA NA NA NA NA NA NA NA NA BG NA NA NA
NA NA NA NA NA NA NA NA NA NA NA NA NA BG BG NA NA BG BG NA NA NA BG BG NA NA NA NA NA NA NA NA NA NA NA NA BG NA NA NA
NA NA NA NA NA NA NA NA NA NA NA NA NA NA NA NA NA BG BG NA NA NA BG BG NA NA NA NA NA NA NA NA NA NA NA NA NA NA NA NA
NA NA NA NA NA NA NA NA NA NA NA NA NA NA NA NA NA BG BG NA NA NA BG BG NA NA NA NA NA NA BG NA NA NA NA NA NA NA NA NA
NA NA NA NA NA NA NA NA NA NA NA NA NA NA NA NA NA BG BG NA NA NA BG BG NA NA NA NA NA NA BG NA NA NA NA NA NA NA NA NA
NA NA NA NA NA NA NA NA NA NA NA NA NA NA NA NA NA BG BG NA NA NA BG BG NA NA NA NA NA NA NA NA NA NA NA NA NA NA NA NA
NA NA NA NA NA NA NA NA NA NA NA NA NA NA NA NA NA BG BG NA NA NA BG BG NA NA NA NA NA NA NA NA NA NA NA NA BG NA NA NA
NA NA NA NA NA NA NA NA NA NA NA NA NA NA NA NA NA BG BG NA NA NA BG BG NA NA NA NA NA NA NA NA NA NA NA NA BG NA NA NA
NA NA NA NA NA NA NA NA NA NA NA NA NA NA NA NA NA BG BG NA NA NA BG BG NA NA NA NA NA NA NA NA NA NA NA NA NA NA NA NA
NA NA NA NA NA NA NA NA NA NA NA NA NA NA NA NA NA BG BG NA NA NA BG BG NA NA NA NA NA NA BG NA NA NA NA NA NA NA NA NA
NA NA NA NA NA NA NA NA NA NA NA NA NA NA NA NA NA BG BG NA NA NA BG BG NA NA NA NA NA NA BG NA NA NA NA NA NA NA NA NA
NA NA NA NA NA NA NA NA NA NA NA NA NA NA NA BG NA BG BG NA NA NA BG BG NA NA NA NA NA NA NA NA NA NA NA NA NA NA NA NA
NA NA NA NA NA NA NA NA NA NA NA NA NA NA NA NA NA BG BG NA NA NA BG BG NA NA NA NA NA NA NA NA NA NA NA NA BG NA NA NA
NA NA NA NA NA NA NA NA NA NA NA NA NA NA NA NA NA BG BG NA NA NA BG BG NA NA NA NA NA NA NA NA NA NA NA NA BG NA NA NA
NA NA NA NA NA NA NA NA NA NA NA NA NA NA NA NA NA BG BG NA NA NA BG BG NA NA NA NA NA NA NA NA NA NA NA NA NA NA NA NA
NA NA NA NA NA NA NA NA NA NA NA NA NA NA NA NA NA BG BG NA NA NA BG BG BG NA NA NA NA NA BG NA NA NA NA NA NA NA NA NA
NA NA NA NA NA NA NA NA NA NA NA NA NA NA NA NA NA BG BG NA NA NA NA NA BG BG NA NA NA NA BG NA NA NA NA NA NA NA NA NA
NA NA NA NA NA NA NA NA NA NA NA NA NA NA NA NA NA NA BG NA NA NA NA NA BG BG NA NA NA NA NA NA NA NA NA NA NA NA NA NA
NA NA NA NA NA NA NA NA NA NA NA NA NA NA NA NA NA NA NA NA NA NA NA NA NA NA NA NA NA NA NA NA NA NA NA NA NA NA NA NA
NA NA NA NA NA NA NA NA NA NA NA NA NA NA NA NA NA NA NA NA NA NA NA NA NA NA NA NA NA NA NA NA NA NA NA NA NA NA NA NA
BG BG NA NA NA NA NA NA NA NA NA NA BG BG NA NA NA NA NA NA NA NA NA NA NA NA NA NA NA NA NA NA NA NA NA NA NA NA NA NA
BG BG NA NA NA NA NA NA NA NA BG BG BG BG NA NA NA NA NA NA NA NA NA NA NA NA NA NA NA NA NA NA NA NA NA NA NA NA NA NA
BG BG NA NA NA NA NA NA NA NA NA NA NA NA NA NA NA NA NA NA NA NA NA NA NA NA NA NA NA NA NA NA NA NA NA NA NA NA NA NA
BG BG BG BG BG BG BG BG BG BG BG BG BG BG NA NA BG BG BG BG BG BG BG BG BG NA BG BG BG BG BG BG BG BG BG BG BG BG BG BG
BB BB BB BB BB BB BB BB BB BB BB BB BB BB BB BB BB BB BB BB BB BB BB BB BB BB BB BB BB BB BB BB BB BB BB BB BB BB BB BB
